0 0 0 0 0 0 0 0 0 0 0 0 0 0 0 0
0 0 0 0 0 0 3 3 0 0 0 0 3 3 3 0
0 0 0 0 3 3 3 3 3 3 0 0 3 2 3 0
0 3 3 3 3 3 3 6 3 3 3 3 3 3 3 0
0 3 1 3 3 6 0 0 3 3 3 3 3 7 0 0
0 3 3 3 0 0 0 0 0 0 3 3 3 0 0 0
0 0 3 0 0 0 0 0 0 0 0 3 0 0 0 0
0 0 3 0 0 0 0 0 0 0 0 3 0 0 0 0
0 0 3 7 0 0 0 0 0 0 7 3 0 0 0 0
0 0 3 3 0 0 0 0 0 0 3 3 0 0 0 0
0 0 0 5 0 0 0 0 0 0 5 0 0 0 0 0
0 0 0 0 0 0 0 0 0 0 0 0 0 0 0 0
