0 0 0 0 0 0 0 0 0 0 0 0 0 0 0 0 0
0 0 0 0 0 0 0 0 0 0 0 0 0 3 3 3 0
0 0 0 3 3 3 7 7 3 3 3 7 7 3 3 3 0
0 0 0 3 3 3 0 0 6 1 3 0 0 3 3 3 0
0 0 0 3 3 3 0 0 3 3 3 0 0 0 0 0 0
0 0 0 3 6 3 0 0 9 3 6 0 0 0 0 0 0
0 0 0 3 3 3 0 0 3 3 3 0 0 0 0 0 0
0 3 3 3 3 0 0 0 3 3 3 7 7 6 3 3 0
0 3 6 0 0 0 0 0 0 0 0 0 0 3 3 3 0
0 0 0 0 0 0 0 0 0 0 0 0 0 3 2 3 0
0 0 0 0 0 0 0 0 0 0 0 0 0 3 3 3 0
0 0 0 0 0 0 0 0 0 0 0 0 0 0 0 0 0
