0 0 0 0 0 0 0 0 0 0 0 0 0 0 0 0 0
0 0 0 0 0 0 0 0 0 0 0 0 3 3 3 3 0
0 0 3 3 3 3 7 7 3 6 3 3 3 3 1 3 0
0 0 3 3 3 3 0 0 0 0 0 0 0 3 3 3 0
0 0 3 3 6 3 0 0 0 0 0 0 0 0 0 0 0
0 0 3 3 3 3 0 0 0 0 0 0 0 0 0 0 0
0 0 0 0 3 3 3 6 3 7 7 3 3 3 0 0 0
0 0 0 0 0 0 0 0 0 0 0 3 3 3 3 6 0
0 3 3 3 0 0 0 0 0 0 0 3 3 3 3 3 0
0 3 2 3 3 3 7 7 3 3 3 3 3 3 0 0 0
0 3 3 3 3 0 0 0 0 0 0 0 0 0 0 0 0
0 0 0 0 0 0 0 0 0 0 0 0 0 0 0 0 0
