0 0 0 0 0 0 0 0 0 0 0 0 0 0 0 0
0 0 0 0 0 0 0 0 0 0 0 0 0 3 5 0
0 0 0 3 3 7 7 3 3 0 0 0 3 3 3 0
0 0 3 3 3 7 7 3 3 0 0 3 5 3 3 0
0 0 3 2 3 0 0 0 3 3 3 3 3 0 0 0
0 0 3 3 3 0 0 0 0 3 3 3 0 0 0 0
0 0 0 0 0 0 0 0 0 0 3 3 0 0 0 0
0 0 0 0 0 3 3 3 0 0 3 1 0 0 0 0
0 3 3 7 7 3 5 3 0 0 3 3 0 0 0 0
0 3 3 7 7 3 3 3 3 3 3 3 0 0 0 0
0 0 0 0 0 0 0 0 0 0 0 0 0 0 0 0
