0 0 0 0 0 0 0 0 0 0 0 0 0 0 0 0
0 0 0 0 0 0 0 0 0 0 0 3 3 3 3 0
0 0 0 0 7 3 3 3 3 3 3 3 5 3 9 0
0 0 1 7 7 3 5 3 0 0 0 3 3 3 3 0
0 5 3 0 0 3 3 0 0 0 0 0 0 3 0 0
0 3 3 0 0 3 0 0 0 0 0 0 0 3 0 0
0 3 3 3 3 3 0 0 0 0 0 3 3 3 0 0
0 3 3 3 0 0 3 3 3 7 7 3 2 3 0 0
0 0 0 0 0 0 5 3 7 0 0 3 3 3 0 0
0 0 0 0 0 0 0 0 0 0 0 0 0 0 0 0
