0 0 0 0 0 0 0 0 0 0 0 0 0 0 0 0 0
0 0 0 6 7 7 3 0 0 0 3 7 7 5 0 0 0
0 0 0 0 0 0 3 0 0 0 3 0 0 0 0 0 0
0 0 0 0 0 0 3 3 3 3 3 0 0 0 0 0 0
0 5 7 7 3 3 3 3 1 3 3 3 3 7 7 5 0
0 0 0 0 0 0 3 3 3 3 3 0 0 0 0 0 0
0 0 0 0 0 0 7 3 0 0 3 0 0 0 0 0 0
0 0 0 0 0 0 7 3 0 0 3 7 7 6 0 0 0
0 3 3 3 0 0 3 3 0 0 3 0 0 0 0 0 0
0 3 2 3 7 7 3 0 0 0 3 0 0 0 0 0 0
0 3 3 3 7 0 0 0 0 0 3 7 7 6 0 0 0
0 0 0 0 0 0 0 0 0 0 0 0 0 0 0 0 0
