0 0 0 0 0 0 0 0 0 0 0 0 0 0 0
0 0 9 0 0 0 0 0 0 0 0 3 3 3 0
0 9 3 9 7 7 5 5 7 7 7 3 2 3 0
0 0 9 0 0 0 0 0 0 0 0 3 3 3 0
0 0 0 0 0 0 0 0 0 0 0 0 0 0 0
0 0 0 3 3 3 0 0 0 3 3 3 0 0 0
0 0 0 3 1 3 3 3 3 3 9 3 0 0 0
0 0 0 3 3 3 0 0 0 3 3 3 0 0 0
0 0 0 0 0 0 0 0 0 0 0 0 0 0 0
