0 0 0 0 0 0 0 0 0 0 0 0 0 0 0 0
0 3 3 3 0 0 0 0 0 3 3 3 3 3 3 0
0 3 2 3 7 7 3 7 7 3 1 3 3 9 3 0
0 3 3 3 0 0 0 0 0 3 3 3 3 7 0 0
0 0 0 0 0 0 0 0 0 0 3 3 3 7 0 0
0 0 0 0 0 0 0 0 0 0 0 0 3 3 0 0
0 0 0 0 0 0 0 0 0 0 0 0 0 3 0 0
0 0 0 0 0 0 0 0 0 0 0 0 0 3 0 0
0 0 0 0 0 0 0 0 0 0 0 0 3 3 0 0
0 0 0 0 0 3 3 3 3 3 0 0 3 3 0 0
0 0 0 0 0 3 6 0 0 3 3 3 5 3 0 0
0 0 0 0 0 0 0 0 0 0 0 0 0 0 0 0
