0 0 0 0 0 0 0 0 0 0 0 0 0 0 0 0
0 0 0 0 0 0 0 0 0 3 3 3 0 0 0 0
0 0 0 0 3 3 3 0 0 3 3 3 0 0 0 0
0 3 7 7 3 1 3 3 3 3 3 3 3 3 3 0
0 3 7 7 3 3 3 0 0 0 0 0 0 5 3 0
0 3 0 0 0 0 0 0 0 0 0 0 0 3 3 0
0 3 0 0 0 0 0 0 0 0 0 0 0 3 3 0
0 3 0 0 0 0 0 0 0 3 3 3 3 3 3 0
0 3 3 3 3 3 0 0 0 3 3 3 0 0 0 0
0 0 3 3 2 3 0 0 0 3 3 3 0 0 0 0
0 0 0 3 3 3 0 0 0 3 3 3 3 3 5 0
0 0 0 0 0 0 0 0 0 0 0 0 0 0 0 0
