0 0 0 0 0 0 0 0 0 0 0 0 0 0 0 0 0
0 0 3 3 7 7 3 3 0 0 0 0 0 0 0 0 0
0 0 3 3 0 0 3 3 3 0 0 0 0 0 0 0 0
0 4 4 1 0 0 3 3 3 3 0 0 0 0 0 0 0
0 4 4 0 0 0 0 0 3 3 3 0 0 0 0 0 0
0 4 4 0 0 0 0 0 0 3 3 3 0 0 0 0 0
0 4 3 3 3 0 0 0 0 0 3 3 9 0 0 0 0
0 0 3 2 3 0 0 0 0 0 0 3 3 3 3 7 0
0 0 3 3 3 3 3 3 0 0 0 3 6 3 3 3 0
0 0 0 3 0 0 3 3 0 0 0 3 3 3 0 0 0
0 0 0 3 0 0 3 3 3 7 7 3 3 7 0 0 0
0 0 0 0 0 0 0 0 0 0 0 0 0 0 0 0 0
