0 0 0 0 0 0 0 0 0 0 0 0 0 0 0 0 0
0 3 3 3 0 0 0 0 3 3 3 3 3 3 3 3 0
0 3 1 3 3 3 3 3 3 3 3 3 0 0 3 3 0
0 3 3 3 0 0 0 0 3 3 0 0 0 0 3 3 0
0 0 0 0 0 0 0 0 0 0 0 0 0 3 5 3 0
0 0 0 0 0 0 0 0 0 0 0 0 0 3 3 0 0
0 3 3 3 0 0 4 4 4 4 3 0 0 6 6 0 0
0 3 2 3 4 4 4 4 4 4 4 0 0 3 3 3 0
0 3 3 3 4 4 4 4 4 4 4 4 4 3 3 3 0
0 0 0 0 0 0 4 4 4 4 4 4 4 3 3 3 0
0 0 0 0 0 0 0 7 3 3 7 0 0 0 0 0 0
0 0 0 0 0 0 0 0 0 0 0 0 0 0 0 0 0
