0 0 0 0 0 0 0 0 0 0 0 0 0 0 0 0 0
0 0 3 3 3 0 0 0 0 0 0 0 0 3 3 3 0
0 0 3 5 3 0 0 0 0 0 0 0 0 3 6 3 0
0 0 3 7 3 0 0 0 3 3 3 7 7 3 3 3 0
0 7 3 3 3 7 0 0 3 2 3 0 0 3 3 6 0
0 3 0 0 0 3 0 0 3 3 3 0 0 0 0 7 0
0 6 0 0 0 3 0 0 4 4 4 0 0 0 0 3 0
0 3 7 7 3 3 3 4 4 4 4 4 3 3 3 3 0
0 0 0 0 3 1 3 4 4 4 4 4 3 9 3 0 0
0 0 0 0 3 3 3 4 4 4 4 4 3 3 3 0 0
0 0 0 0 3 3 3 3 3 7 0 0 0 0 0 0 0
0 0 0 0 0 0 0 0 0 0 0 0 0 0 0 0 0
